3v3-P2Trapped
MaxSteps = 7000
NumShells=30
Rows = 11
Cols = 15
###############
#@@@     1 @@@#
#@2@       @2@#
#@@@       @@@#
# @         @ #
# ########### #
#            1#
#  @  @@@  @  #
#     @2@     #
#1    @@@     #
###############
