3v3-P1Trapped
MaxSteps = 7000
NumShells=30
Rows = 11
Cols = 15
###############
#            2#
#  @@@   @@@  #
#  @1@   @1@  #
#2@@@@   @@@@ #
#  #  #@@#  # #
#     @1@     #
#  @  @@@  @  #
#             #
#2            #
###############
