Complex-Maze
MaxSteps = 8000
NumShells=40
Rows = 12
Cols = 12
############@@@@@
#1  #  @ 2 #
# ## # ## ##
#    #     #
## ####### #
#  @   #   #
# ## #   # #
#   # ###  #
#2 @ # 1   #
# ### ##### 
#     @     
############
